6 6 6 6 6 6 6 6 6 6 6 6 6 6 6 6 6 6 6 6
6 5 5 5 5 5 5 5 5 5 5 5 5 5 5 5 5 5 5 6
6 5 5 5 5 5 5 5 5 5 5 5 5 5 5 5 5 5 5 6
6 5 5 5 5 3 3 3 3 3 5 5 5 5 5 5 5 5 5 6
6 5 5 5 5 3 5 5 5 3 5 5 5 3 3 3 3 5 5 6
6 7 3 3 3 3 5 5 5 3 5 5 5 3 5 5 3 3 3 4
6 5 5 5 5 5 5 5 5 3 5 5 5 3 5 5 5 5 5 6
6 5 5 5 5 5 5 5 5 3 3 3 3 3 5 5 5 5 5 6
6 5 5 5 5 5 5 5 5 5 5 5 5 5 5 5 5 5 5 6
6 5 5 5 5 5 5 5 5 5 5 5 5 5 5 5 5 5 5 6
6 6 6 6 6 6 6 6 6 6 6 6 6 6 6 6 6 6 6 6
